[
  {
    "type": "mapgen",
    "om_terrain": "backfloorchamber_hotel_lobby",
    "object": {
      "fill_ter": "t_red_carpet",
      "rows": [
        "-DD-----------------DD--",
        "-   ------------       -",
        "-   -..b..-..b.-  --ccc-",
        "-   -..b..-..b.-  =====-",
        "-   -.....-....-  =====-",
        "-   -.....-....-  =====-",
        "-   ---D----D---  ------",
        "-                     =-",
        "-  ----D----D----     =-",
        "-  -.....-.......-    =-",
        "-  -..b..-..b... -    =-",
        "-  -..b..-..b... -    =-",
        "-  -.....-....   -    =-",
        "-  -.....-.......-    =-",
        "-  ---------------    =-",
        "-                     =-",
        "-  ----D---   ------===-",
        "-  -m.....-   -b   -==.-",
        "-  -......-   D    -=.=-",
        "-  -b.....-   -b   --- -",
        "-  -b..c..-   ------   -",
        "-  --------         -- -",
        "-              -       -",
		"-DD------------------DD-"
      ],
      "palettes": [ "backrooms_palette_hotel" ]
    }
  }
]