[
  {
    "type": "mapgen",
    "om_terrain": "backfloorchamber_hotelb",
    "object": {
      "fill_ter": "t_red_carpet",
      "rows": [
        "-==-----------------==--",
        "-===---------------====-",
		"-===-.............---==-",
		"-===-.=b.....b.===-====-",
		"-=.=-.=b.....b.===D==-=-",
		"-===-.=c.......===-====-",
		"-===-.=...v....==m-====-",
		"-===---------------=-==-",
		"-=.=======.=========-==-",
		"-==---------------==-==-",
		"-==-==.........==-==-==-",
		"-==-==b.....b..==----==-",
		"-==-==b..x..b..==D=====-",
		"-==-==........===-=====-",
		"-==-==...v.....==-----=-",
		"-==---------------=====-",
		"-======================-",
		"-==----D---===------===-",
		"-==-m.....-===-b===-===-",
		"-==-......-===-====D===-",
		"-==-b.....-===-b===-===-",
		"-==-b..c..-===------===-",
		"-==--------============-",
		"-DD-----------------DD--"
      ],
      "palettes": [ "backrooms_palette_hotel" ]
    }
  }
]