[
  {
    "type": "mapgen",
    "om_terrain": "backfloorchamber_hotel_shifted",
    "object": {
      "fill_ter": "t_red_carpet",
      "rows": [
        "-===---------------===--",
        "-...---------------...=-",
        "-...-..............-...-",
        "-...-..b.....b...-...-==",
        "-...-...b...b....-...-==",
        "-...-..c.........-...-==",
        "-...-.....v......-...-==",
        "-...---------------...-=",
        "-......................-",
        "-..---------------....-=",
        "-..-..............-...-=",
        "-..-..b.....b...-...-===",
        "-..-..b.....b...-...-===",
        "-..-..............-...-=",
        "-..-.....v.......-...-==",
        "-..---------------....-=",
        "-......................-",
        "-..----D---...------..-=",
        "-..-m..........-b...-..-",
        "-..-...........-....D-.-",
        "-..-b..........-b...-..-",
        "-..-b..c.......------..-",
        "-..--------...........-=",
        "-======================-"
      ],
      "palettes": [ "backrooms_palette_hotel" ]
    }
  }
]