[
  {
    "type": "mapgen",
    "om_terrain": "backfloorchamber_hotel_doors",
    "object": {
      "fill_ter": "t_red_carpet",
      "rows": [
        "-D---------------DDDDD--",
        "........DDDDDDDD........",
        "........D......D........",
        "........D......D........",
        "........D......D........",
        "........D......D........",
        "........D......D........",
        "........D......D........",
        "........D......D........",
        "........DDDDDDDD........",
        "........................",
        "........DDDDDDDD........",
        "........D......D........",
        "........D......D........",
        "........D......D........",
        "........D......D........",
        "........D......D........",
        "........DDDDDDDD........",
        "........................",
        "........DDDDDDDD........",
        "........D......D........",
        "........D......D........",
        "........D......D........",
        "........DDDDDDDD........"
      ],
      "palettes": [ "backrooms_palette_hotel" ]
    }
  }
]
