[
  {
    "type": "mapgen",
    "om_terrain": "backfloorchamber_async_dead",
    "object": {
      "fill_ter": "t_metal_floor",
      "rows": [
        "-......................-",
        "-......................-",
        "-......................-",
        "-......................-",
        "-......................-",
        "-..R..R..R..R..R..R....-",
        "-..R..R..R..R..R..R..-..",
        "-..R..R..R..R..R..R..-..",
        "-......................-",
        "-......................-",
        "-......................-",
        "-......................-",
        "-......................-",
        "-......................-",
        "-......................-",
        "-......................-",
        "-......................-",
        "-......................-",
        "-......................-",
        "-......................-",
        "-......................-",
        "-......................-",
        "-......................-",
        "-......................-"
      ],
      "palettes": [ "backrooms_palette_station" ],
       "place_loot": [
      {
        "item": "async_data_drive",
        "x": 11,
        "y": 11,
        "chance": 100,
        "repeat": [1, 1]
      },
      {
        "group": "backrooms_master_trash",
        "x": 11,
        "y": 5,
        "chance": 50,
        "repeat": [1, 2]
      }
    ],
    "place_monster": [
      {
        "monster": "mon_bacteria",
        "x": 11,
        "y": 12,
        "friendly": false
      }
    ]
  }
}
]